BEB = "countries/Berabish.txt"
CHN = "countries/Chinguetti.txt"
DRM = "countries/Darmankur.txt"
KAY = "countries/Kayor.txt"
LAM = "countries/Lamtuna.txt"
MAQ = "countries/Maqil.txt"
SII = "countries/Siine.txt"
SLM = "countries/Saloum.txt"
TRZ = "countries/Trarza.txt"
WAA = "countries/Waalo.txt"
WAD = "countries/Wadan.txt"
WLT = "countries/Walata.txt"
ZAW = "countries/Zawiya.txt"
ZNG = "countries/Zenaga.txt"

ALM = "countries/AlMaris.txt"
QER = "countries/Qerri.txt"
BAG = "countries/Baggara.txt"
TEG = "countries/Tegali.txt"
NUE = "countries/Nuer.txt"
DNK = "countries/Dinka.txt"
SHI = "countries/Shilluk.txt"
FAZ = "countries/Fazughli.txt"
ZGH = "countries/Zaghawa.txt"
DDJ = "countries/DarDaju.txt"
TUJ = "countries/Tunjur.txt"
DHL = "countries/Dahlak.txt"

AJJ = "countries/Ajjer.txt"
AHA = "countries/Ahaggar.txt"
IWE = "countries/Maghsharan.txt"
ADG = "countries/Adagh.txt"
CYR = "countries/Cyrenaica.txt"
AIT = "countries/Ait Abbas.txt"
TOO = "countries/Toubou.txt"
KUK = "countries/Kuku.txt"

ALL = "countries/Allada.txt"
BAO = "countries/Baol.txt"
BIR = "countries/Biram.txt"
BOR = "countries/Bornu.txt"
CBR = "countries/Calabar.txt"
DIA = "countries/Diafunu.txt"
DUR = "countries/Daura.txt"
GOB = "countries/Gobir.txt"
GUR = "countries/Gurma.txt"
GYA = "countries/Gyaman.txt"
HUE = "countries/Hueda.txt"
IBA = "countries/Ibani.txt"
IDO = "countries/Idoma.txt"
IGA = "countries/Igala.txt"
IGB = "countries/Igbo.txt"
KEB = "countries/Kebbi.txt"
KWA = "countries/Kwararafa.txt"
SSS = "countries/Sosso.txt"
TAM = "countries/Tamasheq.txt"
TEN = "countries/Tenkodogo.txt"
WAG = "countries/Wagadugu.txt"
ZAM = "countries/Zamfara.txt"
<<<<<<< Updated upstream
ZND = "countries/Zandoma.txt"
=======

KOT = "countries/Kotoko.txt"
MND = "countries/Mandara.txt"
>>>>>>> Stashed changes
